red: 0,A
green: 1,B
blue: 2,C
orange: 3,T,E,S,L,V
cyan: I
++++++++++++++
+ TEST LEVEL +
++++CCCCCC++++
+AB   B   B a+
+   B   B   0+
++++CC+++++B++
+1    +B+  Cb+
+BT++        +
+CEC+++AA+++++
+BS2  +      +
+cT   A   3  +
+     +      +
+++++++      +
+ test level +
+ TEST LEVEL +
++++++++++++++